nr	人名	名词代码 n和“人(ren)”的声母并在一起。
wb	百分号千分号，全角：％ ‰ 半角：%
wd	逗号，全角：， 半角：,
nt	机构团体	“团”的声母为 t，名词代码n和t并在一起。
nr1	汉语姓氏
d	副词	取 adverb的第2个字母，因其第1个字母已用于形容词。
nrf	音译人名
cc	并列连词
qv	动量词
g	语素	绝大多数语素都能作为合成词的“词根”，取汉字“根”的声母。
p	介词	取英语介词 prepositional的第1个字母。
Ng	名语素	名词性语素。名词代码为 n，语素代码ｇ前面置以N。
vg	动语素	动词性语素。动词代码为 v。在语素的代码g前面置以V。
ag	形容词性语素
bl	区别词性惯用语
vshi	动词“是”
vx	形式动词
pba	介词“把”
udeng	等 等等 云云
rys	处所疑问代词
ww	问号，全角：？ 半角：?
rr	人称代词
Ag	形语素	形容词性语素。形容词代码为 a，语素代码ｇ前面置以A。
wt	叹号，全角：！ 半角：!
s	处所词	取英语 space的第1个字母。
a	形容词	取英语形容词 adjective的第1个字母。
ude2	地
ns	地名	名词代码 n和处所词代码s并在一起。
u	助词	取英语助词 auxiliary
vd	副动词	直接作状语的动词。动词和副词的代码并在一起。
k	后接成分	
z	状态词	取汉字“状”的声母的前一个字母。
vn	名动词	指具有名词功能的动词。动词和名词的代码并在一起。
wf	分号，全角：； 半角： ;
r	代词	取英语代词 pronoun的第2个字母,因p已用于介词。
uzhi	之
wn	顿号，全角：、
rzt	时间指示代词
b	区别词	取汉字“别”的声母。
udh	的话
an	名形词	具有名词功能的形容词。形容词代码 a和名词代码n并在一起。
xu	网址URL
ws	省略号，全角：…… …
al	形容词性惯用语
rzv	谓词性指示代词
xx	非语素字
vl	动词性惯用语
j	简称略语	取汉字“简”的声母。
i	成语	取英语成语 idiom的第1个字母。
rzs	处所指示代词
c	连词	取英语连词 conjunction的第1个字母。
m	数词	取英语 numeral的第3个字母，n，u已有他用。
x	非语素字	非语素字只是一个符号，字母 x通常用于代表未知数、符号。
ng	名词性语素
o	拟声词	取英语拟声词 onomatopoeia的第1个字母。
ad	副形词	直接作状语的形容词。形容词代码 a和副词代码d并在一起。
qt	时量词
ryt	时间疑问代词
pbei	介词“被”
t	时间词	取英语 time的第1个字母。
rz	指示代词
w	标点符号	
uguo	过
nrj	日语人名
nz	其他专名	“专”的声母的第 1个字母为z，名词代码n和z并在一起。
tg	时语素	时间词性语素。时间词代码为 t,在语素的代码g前面置以T。
un	未知词	不可识别词及用户自定义词组。取英文Unkonwn首两个字母。(非北大标准，CSW分词中定义)
wj	句号，全角：。
nl	名词性惯用语
wp	破折号，全角：—— －－ ——－ 半角：--- ----
uzhe	着
uls	来讲 来说 而言 说来
f	方位词	取汉字“方”
wh	单位符号，全角：￥ ＄ ￡ ° ℃ 半角：$
wkz	左括号，全角：（ 〔 ［ ｛ 《 【 〖 〈 半角：( [ { <
vf	趋向动词
rg	代词性语素
wm	冒号，全角：： 半角： :
nr2	汉语名字
wyy	右引号，全角：” ’ 』
vi	不及物动词（内动词）
vyou	动词“有”
ryv	谓词性疑问代词
nsf	音译地名
ulian	连 （“连小学生都会”）
ude3	得
q	量词	取英语 quantity的第1个字母。
l	习用语	习用语尚未成为成语，有点“临时性”，取“临”的声母。
mq	数量词
ry	疑问代词
v	动词	取英语动词 verb的第一个字母。
n	名词	取英语名词 noun的第1个字母。
y	语气词	取汉字“语”的声母。
uyy	一样 一般 似的 般
ude1	的 底
e	叹词	取英语叹词 exclamation的第1个字母。
wky	右括号，全角：） 〕 ］ ｝ 》 】 〗 〉 半角： ) ] { >
h	前接成分	取英语 head的第1个字母。
ule	了 喽
wyz	左引号，全角：“ ‘ 『
usuo	所
dg	副语素	副词性语素。副词代码为 d，语素代码ｇ前面置以D。
